Men (Park)	Women (Park)
Gavin Bottger (USA)	Hiraki Kokona (JPN)
Jagger Easton (USA)	Kusaki Hinano (JPN)
Augusto Akio (BRA)	Sky Brown (GBR)
Tate Carew (USA)	Naia Laso (ESP)
Luigi Cini (BRA)	Yosozumi Sakura (JPN)
Pedro Barros (BRA)	Minna Stess (USA)
Tom Schaar (USA)	Raicca Ventura (BRA)
Kieran Woolley (AUS)	Ruby Trew (AUS)
Danny Leon (ESP)	Bryce Wettstein (USA)
Steven Pineiro (PUR)	Lilly Stoephasius (GER)
Keegan Palmer (AUS)	Arisa Trew (AUS)
Liam Pace (USA)	Ruby Lilley (USA)
Nagahara Yuro (JPN)	Lola Tambling (GBR)
Hampus Winberg (SWE)	Dora Varella (BRA)
Keefer Wilson (AUS)	Grace Marhoefer (USA)
Viktor Solmunde (DEN)	Yndiara Asp (BRA)
Pedro Quintas (BRA)	Hasegawa Mizuho (JPN)
Alessandro Mazzara (ITA)	Jordyn Barratt (USA)
Alex Sorgente (ITA)	Lillian Erickson (USA)
Pedro Carvalho (BRA)	Isadora Pacheco (BRA)
Ash Wilcomes (AUS)	Sugawara Mei (JPN)
Taylor Nye (USA)	Cho Hyunju (KOR)
Vincent Matheron (FRA)	Nakamura Kisa (JPN)
Elias Nilsen (NOR)	Emilie Alexandre (FRA)
Tyler Edtmayer (GER)	Heili Sirvio (FIN)
Murilo Peres (BRA)	Fay Ebert (CAN)
Rune Glifberg (DEN)	Julia Benedetti (ESP)
Tommy Calvert (GBR)	Poppy Starr (AUS)
Peio Gonzalez (ESP)	Charlotte Heath (AUS)
Noe Montagard (FRA)	Nana Taboulet (FRA)
Thomas Augusto (POR)	Gadea Moja (ESP)
Kiki Francisco (PHL)	Lilly Strachan (GBR)
Egoitz Bijueska (ESP)	Aaliyah Wilson (AUS)
Yam Behar (ISR)	Coco Crafter (AUS)
Edouard Damestoy (FRA)	Li Yujuan (CHN)
Ethan Copeland (AUS)	Hedda Hjertberg (SWE)
Omar Cocilova (ARG)	Zheng Haohao (CHN)
George O'Neill (GBR)	Victoria Bassi (BRA)
Alain Kortabitarte (ESP)	Lucrezia Zarattini (ITA)
Andrew Macdonald (GBR)	Madeleine Larcheron (FRA)
Tom Martin (FRA)	Fernanda Tonissi (BRA)
Phoenix Sinnerton (AUS)	Ceci Rendueles (ESP)
Chen Ye (CHN)	Alisa Fessi (AUT)
Dallas Oberholzer (RSA)	Aya Asaqas (MAR)


Men (Street)	Women (Street)
Shirai Sora (JPN)	Nishiya Momiji (JPN)
Nyjah Huston (USA)	Rayssa Leal (BRA)
Gustavo Ribeiro (POR)	Oda Yumeka (JPN)
Aurelien Giraud (FRA)	Chloe Covell (AUS)
Netsuke Kairi (JPN)	Akama Liz (JPN)
Onodera Ginwoo (JPN)	Nakayama Funa (JPN)
Horigome Yuto (JPN)	Yoshizawa Coco (JPN)
Richard Tury (SVK)	Pamela Rosa (BRA)
Kevin Hoefler (BRA)	Ito Miyu (JPN)
Sasaki Toa (JPN)	Paige Heyn (USA)
Cordano Russell (CAN)	Gabi Mazetto (BRA)
Jagger Eaton (USA)	Roos Zwetsloot (NED)
Vincent Milou (FRA)	Cui Chenxi (CHN)
Ryan Decenzo (CAN)	Daniela Terol (ESP)
Aoki Yukito (JPN)	Liv Lovelace (AUS)
Alex Milder (USA)	Keet Oldenbeuving (NED)
Giovanni Vianna (BRA)	Haylie Powell (AUS)
Chris Joslin (USA)	Zeng Wenhui (CHN)
Matias Dell Olio (ARG)	Natalia Munoz (ESP)
Braden Hoban (USA)	Mariah Duran (USA)
Mauro Iglesia (ARG)	Lucie Schoonheere (FRA)
Felipe Gustavo (BRA)	Lore Bruggeman (BEL)
Gabryel Augilar (BRA)	Jazmin Alvarez (COL)
Matt Berger (CAN)	Poe Pinson (USA)
Jhancarlos Gonzalez Ortiz (COL)	Candy Jacobs (NED)
Deivid Tuesta (PER)	Charlotte Hym (FRA)
Micky Papa (CAN)	Felicity Turner (AUS)
Joseph Garbaccio (FRA)	Ha Siye (KOR)
Shane O'Neill (AUS)	Kemily Suiara (BRA)
Angelo Caro (PER)	Zhang Yan (CHN)
Jake Ilardi (USA)	Zhu Yuanling (CHN)
Rome Collyer (AUS)	Isabelly Avila (BRA)
Greg Rodriguez (MEX)	Jessica Ready (NZL)
Kristoffer Kroon (SWE)	Afrika Criado Oliva (ESP)
Justin Sommer (GER)	Aldana Bertran (ARG)
Lucas Rabelo (BRA)	Jeromine Lourvet (FRA)
Joe Hinson (GBR)	Samantha Secours (CAN)
Tommy Flynn (AUS)	Vareeraya Sukasem (THA)
Filipe Mota (BRA)	Lan Junyi (CHN)
Agustin Aquila (ITA)	Ailin Arzua (ARG)
Kilian Zehnder (SUI)	Meagan Guy (USA)
Gabriel Ribeiro (POR)	Marina Gabriela (BRA)
Brandon Valjalo (RSA)	Weronika Choromanska (POL)
Zhang Jie (CHN)	Boipelo Awuah (RSA)


Saturday, July 27

Men's street prelims: 6 a.m. ET
Men's street final: 11 a.m. ET
Sunday, July 28

Women's street prelims: 6 a.m. ET
Women's street final: 11 a.m. ET
Tuesday, Aug. 6

Women's park prelims: 6:30 a.m. ET
Women's park final: 11:30 a.m. ET
Wednesday, Aug. 7

Men's park prelims: 6:30 a.m. ET
Men's park final: 11:30 a.m. ET